############B#
#     #      #
# ### ###### #
#   #      # #
### # #### # #
#   #    # # #
# ###### # # #
#        #   #
###### #######
#            #
######A#######
