#######B
#     #
# ### #
# #   #
# # ###
#     #
### ####
A      #
#######
